1122111111111111
1000300000000001
1011101110111001
1000100000100001
1010101010101001
1000100000100001
1011101110111001
1000000000000001
1111111111111111